---------------------(Room Tiles)----------------------
		
r  0  0  0  0  0  0  0  0  0  0  0  0  0  0  0  0  0  0
r  0  0  0  0  0  0  0  0  0  0  0  0  0  0  0  0  0  0
r  0  0  0  0  0  0  0  0  0  0  0  0  0  0  0  0  0  0
r  0  0  0  0  5  1  1  1  1  1  1  1  1  5  0  0  0  0
r  0  0  0  5  5  1  1  2  3  3  2  1  1  5  5  0  0  0
r  0  0  1  1  1  1  2  3  5  5  3  2  1  1  1  1  0  0
r  0  0  1  1  1  2  2  3  5  5  3  2  2  1  1  1  0  0
r  0  0  1  1  1  2  2  2  3  3  2  2  2  1  1  1  0  0
r  3  6  6  6  6  6  2  2  2  2  2  2  6  6  6  6  6  3
r  3  6  6  6  5  4  3  2  2  2  2  3  4  5  6  6  6  3
r  3  6  6  6  5  4  3  2  0  0  2  3  4  5  6  6  6  3
r  3  3  3  3  3  3  3  3  0  0  3  3  3  3  3  3  3  3

------------------- Special Tiles --------------------
------(Y pos/ Object type/ tileIndexPos/ Rot)---------

s 0/0/127/0
s 0/0/142/0
s 0/6/19/0

