---------------------(Room Tiles)----------------------
		
r 0  0  0  0  0  0  0  0  0  0  0  0  0  0  0  0  0
r 0  0  0  0  2  2  0  0  0  0  0  0  0  2  0  0  0
r 0  0  0  2  5  2  1  0  0  0  0  1  2  5  2  2  0
r 0  0  2  5  5  2  1  1  1  1  1  1  2  5  5  2  0
r 0  0  2  2  2  1  2  2  3  3  2  2  2  2  2  0  0
r 0  0  1  1  1  2  2  3  5  5  3  2  2  1  1  0  0
r 0  0  1  1  1  2  2  3  5  5  3  2  2  1  1  0  0
r 0  2  2  2  2  2  2  2  3  3  2  2  2  2  2  2  0
r 0  6  6  6  6  6  2  2  2  2  2  2  6  6  6  6  0
r 0  6  6  6  6  6  6  0  0  0  2  6  6  6  6  6  0
r 0  6  6  6  5  4  2  0  0  0  2  3  4  5  6  6  0

------------------- Special Tiles --------------------
------(Y pos/ Object type/ tileIndexPos/ Rot)---------

s 0/0/160/0
s 0/0/145/0
s 0/3/135/0
s 0/27/112/0
s 0/27/121/0
s 1/8/157/0
s 0/4/164/0