---------------------(Room Tiles)----------------------
	
r 3  3  3  3  3  3  3  0  0  0  0  3  3  3  3  3  3  3
r 3  0  0  0  0  0  0  0  0  0  0  0  0  0  0  0  0  3
r 3  0  4  0  0  0  0  3  3  3  3  0  0  0  0  4  0  3
r 3  0  0  0  0  0  3  1  1  1  1  3  0  0  0  0  0  3
r 0  0  0  0  0  0  3  1  2  2  1  3  0  0  0  0  0  0
r 0  0  0  0  0  0  3  1  2  2  1  3  0  0  0  0  0  0
r 0  0  0  0  0  0  3  1  2  2  1  3  0  0  0  0  0  0
r 0  0  0  0  0  0  3  1  1  1  1  3  0  0  0  0  0  0
r 3  0  0  0  0  0  0  3  3  3  3  0  0  0  0  0  0  3
r 3  0  4  0  0  0  0  0  0  0  0  0  0  0  0  4  0  3
r 3  3  0  0  0  0  0  0  0  0  0  0  0  0  0  0  3  3
r 3  3  3  3  3  3  0  0  0  0  0  3  3  3  3  3  3  3

------------------- Special Tiles --------------------
------(Y pos/ Object type/ tileIndexPos/ Rot)---------

s 1/0/35/0
s 1/0/55/0
s 1/0/65/0
s 1/2/36/0
s 0/27/113/0
s 0/27/120/0
s 0/39/98/7
s 1/4/80/0