---------------------(Room Tiles)----------------------
	
r 3  3  3  3  3  3  0  0  0  0  0  3  3  3  3  3  3  3
r 3  0  0  0  0  0  0  0  0  0  0  0  0  0  0  0  0  3
r 3  0  4  0  0  0  0  0  0  0  0  0  0  0  0  4  0  3
r 3  0  0  0  0  0  0  1  1  1  1  0  0  0  0  0  0  3
r 0  0  0  0  0  0  0  1  5  5  1  0  0  0  0  0  0  0
r 0  0  0  0  0  0  0  1  5  5  1  0  0  0  0  0  0  0
r 0  0  0  0  0  0  0  1  5  5  1  0  0  0  0  0  0  0
r 0  0  0  0  0  0  0  1  1  1  1  0  0  0  0  0  0  0
r 3  0  0  0  0  0  0  0  0  0  0  0  0  0  0  0  0  3
r 3  0  4  0  0  0  0  0  0  0  0  0  0  0  0  4  0  3
r 3  3  0  0  0  0  0  0  0  0  0  0  0  0  0  0  3  3
r 3  3  3  3  3  3  0  0  0  0  0  3  3  3  3  3  3  3

------------------- Special Tiles --------------------
------(Y pos/ Object type/ tileIndexPos/ Rot)---------


s 1/0/35/0
s 1/0/75/0
s 1/0/95/0
s 0/28/131/0
s 0/28/138/0
s 1/29/117/0
s 1/29/116/0
s 0/5/80/0
s 0/8/181/0