---------------------(Room Tiles)----------------------
	
r 0  0  3  0  0  0  0  0  0  3  3  4
r 0  0  0  0  0  0  0  0  0  0  0  3
r 0  0  0  0  0  0  0  0  0  0  0  3
r 0  0  1  1  1  0  1  1  1  0  0  3
r 0  0  1  3  1  0  1  3  1  0  0  0
r 0  0  1  3  1  0  1  3  1  0  0  0
r 0  0  1  3  1  0  1  3  1  0  0  0
r 0  0  1  1  1  0  1  1  1  0  0  0
r 0  0  0  0  0  0  0  0  0  0  0  3
r 0  0  0  0  0  0  0  0  0  0  0  3
r 0  0  0  0  0  0  0  0  0  0  0  3
r 0  0  0  0  0  0  0  0  0  0  0  0

------------------- Special Tiles --------------------
------(Y pos/ Object type/ tileIndexPos/ Rot)---------

s 0/0/118/0
s 0/0/109/0
s 3/5/149/0
s 0/27/130/0
s 0/27/132/0