---------------------(Room Tiles)----------------------
		
r 0  0  0  0  0  0  0  0  0  0  0  0  0  0  0  0  0  0
r 0  2  0  0  4  0  0  0  0  0  0  0  0  0  0  0  2  0
r 0  0  0  0  0  0  1  1  1  0  0  0  4  0  0  0  0  0
r 0  0  0  0  0  0  1  1  1  0  0  0  0  0  0  0  0  0
r 0  0  0  0  0  0  1  1  1  0  0  0  0  0  0  0  0  0
r 0  0  0  0  0  0  1  1  1  0  0  0  0  0  0  4  0  0
r 0  0  0  0  0  0  1  1  1  0  0  0  0  0  0  0  0  0
r 0  0  0  0  0  0  1  1  1  0  0  0  0  0  0  0  0  0
r 0  0  0  4  0  0  0  0  0  0  0  0  0  0  4  0  0  0
r 0  0  0  0  0  0  0  0  0  0  0  0  0  0  0  0  0  0
r 0  2  0  0  0  0  0  0  0  0  0  0  0  0  0  0  2  0
r 0  0  0  0  0  0  0  0  0  0  0  0  0  0  0  0  0  0

------------------- Special Tiles --------------------
------(Y pos/ Object type/ tileIndexPos/ Rot)---------

s 1/1/25/0
s 1/2/36/0
s 1/1/45/0
s 1/1/84/0
s 1/29/39/0
s 1/7/83/0
s 0/28/86/0
s 0/28/75/0
s 0/8/20/0