---------------------(Room Tiles)----------------------
		
r 0  0  0  0  0  0  0  0  0  0  0  0  0  0  0  0  0  0
r 0  0  0  0  0  0  0  0  0  0  0  0  0  0  0  0  0  0
r 0  0  0 -4 -4 -4 -4 -4 -4 -4 -4  0  0  0  0  0  0  0
r 0  0  0 -4  0  0  0  0  0  0 -4  0  0  0  0  0  0  0
r 0  0  0 -4  0  0  0  0  0  0 -4  0  0  0  0  0  0  0
r 0  0  0 -4  0  0  0  0  0  0 -4  0  0  0  0  0  0  0
r 0  0  0 -4  0  0  0  0  0  0 -4  0  0  0  0  0  0  0
r 0  0  0 -4  0  0  0  0  0  0 -4  0  0  0  0  0  0  0
r 0  0  0 -4  0  0  0  0  0  0 -4  0  0  0  0  0  0  0
r 0  0  0 -4 -4 -4 -4 -4 -4 -4 -4  0  0  0  0  0  0  0
r 0  0  0  0  0  0  0  0  0  0  0  0  0  0  0  0  0  0
r 0  0  0  0  0  0  0  0  0  0  0  0  0  0  0  0  0  0

------------------- Special Tiles --------------------
------(Y pos/ Object type/ tileIndexPos/ Rot)---------

s 0/8/97/0
s 0/1/26/0
s 0/0/59/0
s 0/0/64/0
s 0/0/148/0
s 0/0/153/0	
s 0/26/20/0	
s 0/26/29/0	
s 0/26/182/0	
s 0/26/191/0	