---------------------(Room Tiles)----------------------
		
r 0  3  3  3  3  2  0  0  0  0  0  0  3  2  1  0  0
r 0  3  3  3  3  2  1  0  0  0  3  3  3  2  1  0  0
r 0  3  3  3  3  0  0  0  0  0  3  3  3  3  3  0  0
r 0  0  0  5  5  0  0  0  0  0  0  0  0  0  0  0  0
r 0  0  0  5  5  0  0  0  0  0  0  0  0  0  0  0  0
r 0  0  0  0  0  0  0  6  0  0  0  5  5  5  0  0  0
r 0  0  0  0  0  0  0  6  0  0  6  5  5  5  6  0  0
r 0  0  0  5  5  0  0  6  0  0  6  5  5  5  6  0  0
r 0  6  6  5  5  0  0  0  0  0  6  5  5  5  6  0  0
r 0  5  5  5  5  0  0  0  0  0  6  5  5  5  6  0  0
r 0  5  5  5  5  0  0  0  0  0  6  5  5  5  6  0  0

------------------- Special Tiles --------------------
------(Y pos/ Object type/ tileIndexPos/ Rot)---------

s 6/0/185/0
s 6/0/184/0
s 6/0/145/0
s 6/0/19/0
s 0/2/133/0
s 0/12/176/0
s 0/12/30/0
s 0/10/82/0
s 0/10/60/0
s 1/8/164/0
