---------------------(Room Tiles)----------------------
	
r 0  0  0  0  0  0  0  0  0  0  0  0  0  0  0  0  0  0
r 0  0  0  0  0  0  0  0  0  0  0  0  0  0  0  0  0  0
r 0  0  0  0  0  0  0  0  0  0  0  0  0  0  0  0  0  0
r 0  0  0  0  0  0  2  2  2  2  2  0  0  0  0  0  0  0
r 0  0  0  0  0  0  2  4  4  4  2  0  0  0  0  0  0  0
r 0  0  0  0  0  0  2  4  5  4  2  0  0  0  0  0  0  0
r 0  0  0  0  0  0  2  4  5  4  2  0  0  0  0  0  0  0
r 0  0  0  0  0  0  2  4  4  4  2  0  0  0  0  0  0  0
r 0  0  0  0  0  0  2  2  2  2  2  0  0  0  0  0  0  0
r 0  0  0  0  0  0  0  0  0  0  0  0  0  0  0  0  0  0
r 0  0  0  0  0  0  0  0  0  0  0  0  0  0  0  0  0  0
r 0  0  0  0  0  0  0  0  0  0  0  0  0  0  0  0  0  0

------------------- Special Tiles --------------------
------(Y pos/ Object type/ tileIndexPos/ Rot)---------

s 1/29/97/0
s 1/29/99/0
s 1/30/116/0
s 0/27/56/0
s 0/28/182/0
s 0/28/195/0
s 2/41/192/0
s 2/41/185/0
s 0/39/150/0
s 4/10/74/0
s 0/12/122/0
s 0/2/33/0
s 0/2/211/0
