---------------------(Room Tiles)----------------------
		
r  0  0  0  0  0  0  0  0  0  0  0  0  0  0  0  0  0  0
r  0  3  3  3  0  0  0  0  0  0  0  0  0  0  4  4  4  0
r  0  3  3  3  0  0  0  0  0  0  0  0  0  0  4  4  4  0
r  0  3  3  3  0  0  0  0  0  0  0  0  0  0  4  4  4  0
r  0  0  0  0  0  1  3  5  7  7  5  3  1  0  0  0  0  0
r  0  0  0  0  0  2  4  6  8  8  6  4  2  0  0  0  0  0
r  0  0  0  0  0  2  4  6  8  8  6  4  2  0  0  0  0  0
r  0  0  0  0  0  1  3  5  7  7  5  3  1  0  0  0  0  0
r  0  2  2  2  0  0  0  0  0  0  0  0  0  0  1  1  1  0
r  0  2  2  2  0  0  0  0  0  0  0  0  0  0  1  1  1  0
r  0  2  2  2  0  0  0  0  0  0  0  0  0  0  1  1  1  0
r  0  0  0  0  0  0  0  0  0  0  0  0  0  0  0  0  0  0

------------------- Special Tiles --------------------
------(Y pos/ Object type/ tileIndexPos/ Rot)---------

s 0/0/38/0
s 0/0/51/0
s 0/0/164/0
s 0/0/177/0
s 0/1/188/0
s 0/9/51/0

