---------------------(Room Tiles)----------------------
	
r 0  0  0  0  0  0  0  0  0  0  0  0  0  0  0  0  0  0
r 0  0  0  0  0  0  0  0  0  0  0  0  0  0  0  0  0  0
r 0  0  0  3  0  0  0  0  0  0  0  0  0  3  0  0  0  0
r 0  0  0  0  0  1  1  1  1  1  1  1  0  0  0  0  0  0
r 0  0  0  0  0  1  2  2  2  2  2  1  0  0  0  0  0  0
r 0  0  0  0  0  1  2  2  2  2  2  1  0  0  0  0  0  0
r 0  0  0  0  0  1  2  2  2  2  2  1  0  0  0  0  0  0
r 0  0  0  0  0  1  2  2  2  2  2  1  0  0  0  0  0  0
r 0  0  0  0  0  1  1  1  1  1  1  1  0  0  0  0  0  0
r 0  0  0  3  0  0  0  0  0  0  0  0  0  3  0  0  0  0
r 0  0  0  0  0  0  0  0  0  0  0  0  0  0  0  0  0  0
r 0  0  0  0  0  0  0  0  0  0  0  0  0  0  0  0  0  0

------------------- Special Tiles --------------------
------(Y pos/ Object type/ tileIndexPos/ Rot)---------

s 0/39/136/1