---------------------(Room Tiles)----------------------
	
r 3  3  3  3  3  3  3  0  0  0  0  3  3  3  3  3  3  3
r 3  0  0  0  0  0  0  0  0  0  0  0  0  0  0  0  0  3
r 3  0  4  0  0  0  2  2  2  2  2  2  0  0  0  4  0  3
r 0  0  0  0  0  0  2  1  1  1  1  2  0  0  0  0  0  3
r 0  0  0  0  0  0  2  1  0  0  1  2  0  0  0  0  0  0
r 0  0  0  0  0  0  2  1  0  0  1  2  0  0  0  0  0  0
r 0  0  0  0  0  0  2  1  0  0  1  2  0  0  0  0  0  0
r 0  0  0  0  0  0  2  1  1  1  1  2  0  0  0  0  0  0
r 3  0  0  0  0  0  2  2  2  2  2  2  0  0  0  0  0  3
r 3  0  4  0  0  0  0  0  0  0  0  0  0  0  0  4  0  3
r 3  3  0  0  0  0  0  0  0  0  0  0  0  0  0  0  3  3
r 3  3  3  3  3  3  0  0  0  0  0  3  3  3  3  3  3  3

------------------- Special Tiles --------------------
------(Y pos/ Object type/ tileIndexPos/ Rot)---------

s 0/29/116/0
s 0/30/117/0
s 0/0/113/0
s 0/0/112/0
s 0/0/119/0
s 0/0/120/0
s 0/10/100/0
s 0/12/38/0
s 1/8/181/0
s 0/27/183/0
s 0/27/194/0
