---------------------(Room Tiles)----------------------
		
r 4  3  3  3  3  3  0  0  0  0  3  3  3  3  3  4
r 3  0  0  0  0  0  0  0  0  0  0  0  0  0  0  3
r 3  0  4  4  4  0  1  0  0  0  0  0  0  0  0  3
r 0  0  0  0  0  1  2  1  0  0  0  0  0  0  0  0
r 0  0  0  0  0  1  2  1  0  0  0  0  0  0  0  0
r 0  0  0  0  0  1  2  1  0  0  0  0  0  0  0  0
r 0  0  0  0  0  1  2  1  0  0  0  0  0  0  0  0
r 3  0  0  0  0  1  2  1  0  0  0  0  0  0  0  3
r 3  0  0  0  0  0  1  0  0  0  0  0  0  0  0  3
r 4  3  3  3  3  3  0  0  0  0  3  3  3  3  3  4


------------------- Special Tiles --------------------
------(Y pos/ Object type/ tileIndexPos/ Rot)---------

s 1/0/60/0
s 1/0/110/0
s 1/1/136/0
s 1/2/135/0
s 0/12/139/0
s 1/10/114/0