---------------------(Room Tiles)----------------------
	

r 0  0  0  0  0  0  0  0  0  0  0  0  0  0  0  0  0  0
r 0  0  0  0  0  0  0  0  0  0  0  0  0  0  0  0  0  0
r 0  0  0  0  0  0  0  0  0  0  0  0  0  0  0  0  0  0
r 0  0  3  3  3  3  3  3  3  3  3  3  0  0  0  0  0  0
r 0  0  3  0  0  0  0  0  0  0  0  3  0  3  3  3  3  0
r 0  0  3  0  0  0  0  0  0  0  0  3  0  3  0  0  0  0
r 0  0  3  0  0  0  0  0  0  0  0  3  0  3  0  0  0  0
r 0  0  3  0  0  0  0  0  0  0  0  3  0  3  0  0  0  0
r 0  0  3  3  3  3  0  0  0  0  0  3  0  3  0  0  0  0
r 0  0  0  0  0  3  0  0  0  0  0  3  0  3  0  0  0  0
r 0  0  0  0  0  0  0  0  0  0  0  3  0  0  0  0  0  0
r 0  0  0  0  0  0  0  0  0  0  0  0  0  0  0  0  0  0


------------------- Special Tiles --------------------
------(Y pos/ Object type/ tileIndexPos/ Rot)---------

s 0/0/19/0
s 0/1/20/0
s 0/2/50/0
s 0/10/76/0
s 0/12/78/0

