---------------------(Room Tiles)----------------------
		
r  0  0  0  0  0  0  0  0  0  0  0  0  0  0  0  0  0
r  0  0  0  3  0  0  0  0  0  0  0  0  0  0  0  0  0
r  0  0  0  3  0  0  0  0  0  0  0  0  0  0  0  5  0
r  0  0  0  3  0  0  0  0  0  0  0  0  0  0  0  5  0
r  0  0  3  3  0  0  0  0  0  0  0  0  0  0  0  0  0
r  0  0  0  0  0  0  0  0  5  5  0  0  5  5  0  0  0
r  0  1  0  0  0  0  0  0  5  5  0  0  5  5  0  0  0
r  5  3  1  0  0  0  0  0  0  0  0  0  6  6  6  6  5
r  5  3  3  1  0  0  0  0  0  0  0  6  6  6  6  6  5
r  5  6  3  3  1  0  4  4  0  0  6  6  6  6  6  6  5
r  5  6  6  3  3  1  0  0  0  0  6  6  6  6  6  6  5
r  5  5  5  5  5  5  5  0  0  0  5  5  5  5  5  5  5

------------------- Special Tiles --------------------
------(Y pos/ Object type/ tileIndexPos/ Rot)---------

s 3/0/152/0
s 0/1/45/0
s 5/10/48/0
s 0/12/20/0
s 1/7/114/0
