---------------------(Room Tiles)----------------------
		
r 4  3  3  3  3  0  0  0  0  0  0  3  3  3  3  4
r 3  0  0  0  0  0  0  0  0  0  0  0  0  0  0  3
r 3  0  0  3  0  0  1  0  0  0  0  3  0  0  0  3
r 0  0  0  0  0  1  2  1  0  0  0  0  0  0  0  0
r 0  0  0  0  0  1  2  1  0  0  0  0  0  0  0  0
r 0  0  0  0  0  1  2  1  0  0  0  0  0  0  0  0
r 0  0  0  0  0  1  2  1  0  0  0  0  0  0  0  0
r 3  0  0  0  0  1  2  1  0  0  0  0  0  0  0  3
r 3  0  3  0  0  0  1  0  0  0  0  3  0  0  0  3
r 4  3  3  3  3  0  0  0  0  0  0  3  3  3  3  4


------------------- Special Tiles --------------------
------(Y pos/ Object type/ tileIndexPos/ Rot)---------

s 1/0/25/0
s 1/0/120/0
s 1/0/65/0
s 1/2/37/0
s 2/8/155/0
s 0/25/80/0
s 0/25/76/0