---------------------(Room Tiles)----------------------
		
r 0  0  0  0  0  0  0  0  0  0  0  0  0  0  0  0  0  0
r 0  0  0  0  0  0  0  0  0  0  0  0  0  0  0  0  0  0
r 0  0  0  0  0  0  0  0  0  0  0  0  0  0  0  0  0  0
r 0  0  2  1  1  0  0  0  0  0  0  0  0  1  1  2  0  0
r 0  0  0  0  0  0  0  0  0  0  0  0  0  0  0  0  0  0
r 0  0  2  1  1  0  0  0  0  0  0  0  0  1  1  2  0  0
r 0  0  2  1  1  0  0  1  1  1  1  0  0  1  1  2  0  0
r 0  0  0  0  0  0  1  1  2  2  1  1  0  0  0  0  0  0
r 0  0  2  1  1  0  1  2  2  2  2  1  0  1  1  2  0  0
r 0  0  0  0  0  0  1  2  1  2  2  1  0  0  0  0  0  0
r 0  0  2  1  1  0  1  2  0  0  2  1  0  1  1  2  0  0
r 0  0  0  0  0  0  0  0  0  0  0  0  0  0  0  0  0  0

------------------- Special Tiles --------------------
------(Y pos/ Object type/ tileIndexPos/ Rot)---------

s 2/0/170/0
s 2/0/173/0
s 4/10/150/0
s 4/10/155/0
s 0/12/39/0
s 0/12/50/0
s 0/2/38/0