---------------------(Room Tiles)----------------------
	
r 0  0  0  0  0  0  0  0  0  0  0  0  0  0  0  0  0  0
r 0  0  0  0  0  0  0  0  0  0  0  0  0  0  0  0  0  0
r 0  0  1  1  1  1  1  1  1  1  1  1  1  1  1  1  0  0
r 0  0  1  1  1  1  1  1  1  1  1  1  1  1  1  1  0  0
r 0  0  1  1  2  2  2  2  2  2  2  2  2  2  1  1  0  0
r 0  0  1  1  2  2  2  2  2  2  2  2  2  2  1  1  0  0
r 0  0  1  1  2  2  2  2  2  2  2  2  2  2  1  1  0  0
r 0  0  1  1  2  2  2  2  2  2  2  2  2  2  1  1  0  0
r 0  0  1  1  1  1  1  1  1  1  1  1  1  1  1  1  0  0
r 0  0  1  1  1  1  1  1  1  1  1  1  1  1  1  1  0  0
r 0  0  0  0  0  0  0  0  0  0  0  0  0  0  0  0  0  0
r 0  0  0  0  0  0  0  0  0  0  0  0  0  0  0  0  0  0

------------------- Special Tiles --------------------
------(Y pos/ Object type/ tileIndexPos/ Rot)---------

s 0/36/95/0
s 0/36/99/0
s 0/37/102/0
s 0/36/57/0
s 0/37/59/0
s 0/37/61/0
s 0/36/63/0
s 0/35/65/0
