---------------------(Room Tiles)----------------------
		
r  0  0  0  0  0  0  0  0  0  0  0  0  0  0  0  0
r  0  0  0  0  0  0  0  0  0  0  0  0  0  2  0  0
r  0  0  0  0  0  0  0  0  0  0  0  0  0  3  0  0
r  0  0  3  0  3  0  3  0  3  0  3  0  0  4  0  0
r  0  0  1  1  1  1  1  1  1  1  1  0  0  0  0  0
r  0  0  2  2  2  2  2  2  1  1  1  0  0  0  0  0
r  3  3  3  3  3  2  2  2  1  1  1  0  0  4  0  0
r  3  3  3  3  3  2  1  1  1  1  1  0  0  3  0  0
r  3  3  3  3  3  2  1  0  0  1  1  0  0  2  0  0
r  3  3  3  3  3  2  2  0  0  1  1  0  0  0  0  0

------------------- Special Tiles --------------------
------(Y pos/ Object type/ tileIndexPos/ Rot)---------

s 0/1/148/0
s 0/1/145/0
s 0/0/32/0
s 0/0/158/0
s 0/0/156/0
s 0/0/19/0
s 0/7/145/0
s 0/6/64/0
