---------------------(Room Tiles)----------------------
		
r  3  3  3  3  3  2  0  0  0  0  3  3  3  3  3  0  0  0
r  3  3  3  3  3  2  0  0  0  0  3  3  3  2  1  0  0  0
r  3  3  3  3  3  2  1  1  0  0  3  3  3  2  1  0  0  0
r  3  3  3  3  3  0  0  0  0  0  3  3  3  3  3  0  0  0
r  0  0  0  5  5  0  0  0  0  0  0  0  0  0  0  0  0  0
r  0  0  0  0  0  0  0  0  0  0  0  0  0  0  0  0  0  0
r  0  0  0  0  0  0  0  6  0  0  0  5  5  5  0  0  0  0
r  0  0  0  5  5  0  0  6  0  0  6  5  5  5  6  0  0  0
r  3  6  6  5  5  0  0  0  0  0  6  5  5  5  6  0  0  0
r  3  5  5  5  5  0  0  0  0  0  6  5  5  5  6  0  0  0
r  3  5  5  5  5  0  0  0  0  0  6  5  5  5  6  0  0  0
r  3  3  3  3  3  0  0  0  0  0  3  3  3  3  3  0  0  0

------------------- Special Tiles --------------------
------(Y pos/ Object type/ tileIndexPos/ Rot)---------

s 0/0/185/0
s 0/0/189/0
s 0/0/109/0
s 0/0/52/0
s 0/2/133/0
s 0/10/34/0
s 0/10/187/0
s 0/12/181/0
s 0/12/192/0
s 0/6/182/0

