---------------------(Room Tiles)----------------------
	
r 3  3  3  3  3  3  3  0  0  0  0  3  3  3  3  3  3  3
r 3  0  0  0  0  0  0  0  0  0  0  0  0  0  0  0  0  3
r 3  0  4  0  0  0  0  0  0  0  0  0  0  0  0  4  0  3
r 3  0  0  0  0  0  0  1  1  1  1  0  0  0  0  0  0  3
r 3  0  0  0  0  0  0  1  2  2  1  0  0  0  0  0  0  3
r 0  0  0  0  0  0  0  1  2  2  1  0  0  0  0  0  0  0
r 0  0  0  0  0  0  0  1  2  2  1  0  0  0  0  0  0  0
r 3  0  0  0  0  0  0  1  1  1  1  0  0  0  0  0  0  3
r 3  0  0  0  0  0  0  0  0  0  0  0  0  0  0  0  0  3
r 3  0  4  0  0  0  0  0  0  0  0  0  0  0  0  4  0  3
r 3  3  0  0  0  0  0  0  0  0  0  0  0  0  0  0  3  3
r 3  3  3  3  3  3  0  0  0  0  0  3  3  3  3  3  3  3

------------------- Special Tiles --------------------
------(Y pos/ Object type/ tileIndexPos/ Rot)---------

s 0/0/67/0
s 0/1/103/0
s 0/2/139/0
s 0/3/139/0
s 0/16/139/0