---------------------(Room Tiles)----------------------
		
r  0  0  0  0  0  0  0  0  0  0  0  0  0  0  0  0
r  0  0  0  0  0  0  0  0  0  0  0  0  0  1  1  0
r  0  0  6  6  6  6  0  6  6  6  6  6  0  1  1  0
r  0  0  6  0  0  0  0  0  0  0  6  0  0  0  0  0
r  0  0  6  0  6  6  0  6  6  0  6  6  0  2  2  0
r  0  0  0  0  0  0  0  0  0  0  0  0  0  0  0  0
r  0  0  6  0  6  6  0  5  5  0  6  6  0  3  3  0
r  0  0  6  0  6  6  0  5  0  0  0  0  0  0  0  0
r  0  0  0  0  0  0  0  0  0  4  4  4  4  4  4  0
r  0  0  0  0  0  0  0  0  0  0  0  0  0  0  0  0

------------------- Special Tiles --------------------
------(Y pos/ Object type/ tileIndexPos/ Rot)---------

s 0/10/145/0
s 0/12/128/0
s 0/10/147/0
s 0/12/38/0

